E E W W W W W W W W W W W W W W W W W E E
E E W o B F F F F B b B F F F F B p W E E
W W W B W W W F W F B F W F W W W B W W W
E F F F W F F F W W F W W F F F W F F F E
W W W F W F W F W E E E W F W F W F W W W
E E W F W F F F F E P E F F F F W F W E E
E E W F W W W F W E E E W F W W W F W E E
W W W F F F F F W W W W W F F F F F W W W
W F F F W W W F W W r W W F W W W F F F W
W F W F F W F F F W B W F F F W F F W F W
W F W F F F F W F F F F F W F F F F W F W
W F W W F W F F F W F W F F F W F W W F W
W F W F F W F W W W F W W W F W F F W F W
W F F F F F F W W W F W W W F F F F F F W
W W W W W F W W W F F F W W W F W W W W W
E F F F F F F F F F W F F F F F F F F F E
W W W F W F W F W F F F W F W F W F W W W
E E W F W W W F W W F W W F W W W F W E E
E E W F W W W F W W F W W F W W W F W E E
E E W F F F F F F F r F F F F F F F W E E
E E W W W W W W W W W W W W W W W W W E E