W W W W W W W W W W W W W W W W W W W W W
W W F F F F F W W W p W W W F F F F F W W
W F F W W W F F F F F F F F F W W W F F W
W F W W W W W W W W F W W W W W W W W F W
W F F W W F F F F F F F F F F F W W F F W
W W F W F F W W W W W W W W W F F W F W W
W F F W F W W F F F F F F F W W F W F F W
W F W W F W F F W F F F W F F W F W W F W
W F F W F W F W W B B B W W F W F W F F W
W W F F F W F F B p p p B F F W F F F W W
W F F W F W F F B p p p B F F W F W F F W
W F W W F W F W W B B B W W F W F W W F W
W F F W F W F F W F F F W F F W F W F F W
W W F W F W W F F F F F F F W W F W F W W
W F F W F F W W F W W W F W W F F W F F W
W F W W W F F F F F F F F F F F W W W F W
W F F W W W W W W W W W W W W W W W F F W
W W F F F F F F F F F F F F F F F F F W W
W W W W W W W W W F F W W W W W W W W W W
W p B F F F F F F F F F F F F F F F E P W
W W W W W W W W W W W W W W W W W W W W W
